@@@@@@@@@
@TTTBTTT@
@TTTTTTT@
@TTTTTTT@
@TTT@TTT@
@TT@.@TT@
@!.....!@
@@@@@@@@@