@@@@@@@@
@!##.#!@
@##+*##@
@!#TB#!@
@@@@@@@@