@@@@@@@@
@!#...!@
@.#*+##@
@.+##*.@
@.*##+.@
@##+*#.@
@!...#!@
@@@@@@@@